30 30
111111111111111111111111111111
10000000000000100000080K080001
100011111111101000000100010001
100010000000101000000100010001
1000p0000000101000000100010001
100010000000101000000100010001
100011111111101000000100010001
100000000000008000000100010001
111111111111188000000100010001
100000000000000000000100010001
100000000000000000000100010001
100000000000000000000000000001
100000000000010100000000000001
100040000000010100000000000001
100000000001110111000000999001
10000000000J00M000000000919001
100000000001110111000000999001
100000000000010100000000000001
100000000000010100000000000001
1T1000000000000000000000000001
101000000000000000000000000001
101000000111111111111111111181
101000000000000000000000000001
1F1000000000000000000000000001
101000000123456111111111111181
101000000000000000000000000001
101000000000000000000000000001
101111111000000000000000000001
1@0000Z08000000000000000000001
111111111111111111111111111111
