9 7
00@000J00
0000a0000
0000b0000
0000c0000
0000aaa00
000111a00
000b0aa0Z
