5 5
11111
10001
10@01
100Z1
11111
