10 10
gggggggggg
g00000000g
g00000000g
g00000000g
g000@0000g
g00000000g
g00000000g
g00000000g
g0000000Zg
gggggggggg
