10 10
00@000000Z
0100999900
0000000000
0110000000
0110000000
0000000000
0099001000
0090000000
0099901000
0000000000
