16 16
1111110000111000
10001101100000T0
10@0100011111000
100010M010001111
1101100010Z01111
1101110110001111
1100000111011111
1111011111000111
1110001111110111
1000F0001111p111
1010001011100011
1011111000000011
1010001011100011
1000K0001T110111
1110001110000111
1111111111111111
