32 32
40000000000000040000000000000000
4000@0000004400t0000000000000000
400000444004400t000600006T000600
400000444000000t0000060000600000
400000444000000t0060000600006000
40000000000000040000600006000000
400000004400000t0000006000060000
400000004400000t0006000060000600
404400000000440t0000060000600000
40440000000044040060000600006000
400000000000000t0000600006000000
400000004440000t0000006000060000
400000004440000t000600006F000600
400000004440000t0000060000600000
4000000000T000040060000600006000
44400044444444440000000000000000
00000000000000000000000000000000
00000000000000000000000000000000
00000000000000000022222222222222
00111111111000000000022000020002
00100000001000000002002000020202
00101011111000000002000022000202
00101010001000000002200002220202
00101010101000000002220000020002
0010101T10p000000002222022T22002
0010101011100000000222202202K022
00101010001000000002220000020002
00101011101000000002200002220202
001Z1000001000000002000022000202
00111111111000000002002000020202
00000000000000000000022000020002
00000000000000000022222222222222
