10 10
@11111111Z
0000000011
1101101011
1101001010
0001011000
1100011111
0010110000
0000110111
1110000111
1111110000
