10 10
1111111111
1@00000080
1011000010
1000000010
1000001110
1811000010
1011000110
1111111110
Z000000000
0000000000
