8 5
@000000Z
000000a0
a0000a00
a0000100
aa00000a
